1111111111111111111111111111111111
1E0000000000000C00010C0000000000C1
10100101001000001010010C0000010101
101011001010101C001001000100010101
1P0000010C00C00000000000000C0000C1
1111111111111111111111111111111111